1111111111111111111111111111111111111111
1P00000000C0000000000C0000000000C0000001
1011111111011111111110111111111101111101
1C00000000100000000000000000000000000001
1011111111111111111111111111111111111101
10000000000000000000000000000000000000C0
1111111110111111111111111111111111101101
1000000010000000000000000000000000100001
1011111011111111111111111111111101111101
1C00000100000000000000000000000010000001
1011111111111111111111111111111111111101
100000000000000000000000000000000000C001
1111111111111110111111111110111111111101
10000000000000001000000000100000000000E1
1111111111111111111111111111111111111111