111111111111111111111111111111111111111111111111
1P0000C000000000C000000000000000C000000000000001
101111011111111011111111111111110111111111111101
10000000000000000000000000000000000000000000C001
111111111011111111111111111111111111111011111101
100000000000000000000000000000000000000000000001
101111111111111111111111111111111111111111110101
1C0000000000000000000000000000000000000000000001
101111111111111111111111111111111111111111110101
1000000000000000000000000000000000000000000000C1
111111111111111011111111111111111111111011111111
100000000000000000000000000000000000000000000001
101011111111111111111111111111111111111111111101
100010000000000000000000000000000000000000000001
111010111111111111111111111111111111111111111101
1000000000000000000000000000000000000000000000E1
111111111111111111111111111111111111111111111111