1111111111111111111111111111111111111111111111
1P000000000000000000000000000000000000000000C1
1011111111111111111111111111111111111111101001
1000000000000000000000000000000000000000010001
1011111111111111111111111111111111111111011101
1C00000000000000000000000000000000000000000101
1011111111111111111111111111111111111111010101
1000000000000000000000000000000000000000010101
1011111111111111111111111111111111111111010101
1000000000000000000000000000000000000000010101
1011111111111111111111111111111111111111010101
1000000000000000000000000000000000000000010101
1011111111111111111111111111111111111111010101
1000000000000000000000000000000000000000010101
1011111111111111111111111111111111111111010101
1C000000000000000000000000000000000000000001E1
1111111111111111111111111111111111111111111111