1111111111111111111111
1P00000000000000000C01
1011111111111111111101
1C00000000000000000001
1011111111111111111101
1000000000000000000C01
1011111111111111111101
1C000000000000000000E1
1011111111111111111101
1111111111111111111111