111111111111111
1P00000C0000001
100000000000001
100000000000001
100C000000000E1
111111111111111